1111111111111111111111111
1000000000000000000000001
100100C0000C1000000000001
1000001111100100000000001
1000C000000000C0000000001
1000P0011E000001000000001
1000000000000000000000001
1111111111111111111111111