11111111111111111111111111111111111111111111111111111111111
10000000000C0000000000C0000000000C0000000000000000000000001
10000000000C0000000000C0000000000C0000000000000000000000001
10000000000C0000000000C0000000000C0000000000000000000000001
10000000000C0000000000C0000000000C0000000000000000000000001
10000000000C0000000000C0000000000C0000000000000000000000001
10000000000C0000000000C0000000000C0000000000000000000000001
10000000000C0000000000C0000000000C0000000000000000000000001
10000000000C0000000000C0000000000C0000000000000000000000001
10000000000C0000000000C0000000000C0000000000000000000000001
10000000000C0000000000C0000000000C0000000000000000000000001
10000000000C0000000000C0000000000C0000000000000000000000001
10000000000C0000000000C0000000000C0000000000000000000000001
10000000000C0000000000C0000000000C0000000000000000000000001
10000000000C0000000000C0000000000C0000000000000000000000001
10000000000C0000000000C0000000000C0000000000000000000000001
10000000000C0000000000C0000000000C0000000000000000000000001
10000000000C0000000000C0000000000C0000000000000000000000001
10000000000C0000000000C0000000000C0000000000000000000000001
10000000000C0000000000C0000000000C0000000000000000000000001
10000000000C0000000000C0000000000C0000000000000000000000001
10000000000C0000000000C0000000000C0000000000000000000000001
10000000000C0000000000C0000000000C0000000000000000000000001
10000000000C0000000000C0000000000C0000000000000000000000001
10000000000C0000000000C0000000000C0000000000000000000000001
1P0000E0000010000000000C0000000000C000000000000000000000001
11111111111111111111111111111111111111111111111111111111111